00000000000000111111110111111011111111010111111111111101110111110101111111000000
00000011211121111111110121111011111111011100000000000001110111111101100000011110
00000010000000110000000000021011100000011111211111011111100011011101111111011110
00000010000000110111111121211011111121011111111211011121111111011100000011011000
00000010000000210111111111111011111111011000011000011111211111011111111111011110
00000010000000110110000110000000000121011011011111011100000000011111211111111110
00000010000000110000111121111111111111011011011111011111112111011101110112111110
00001111100000110110111111121112111111011011000011000000110111000001110110000000
00001111100000110110111001100000000011111011111111011110110001011101110111211111
00001111100000110110111011101111111011000011111111011110112111011101110000000011
00001121100000211110111011101111111011111111101111011110111111011101111211011011
00001111100000111110111011111111000011111111101100011000111100011100000000011011
00000000000000110110111000000000011011111111101100011000111112111111111111011011
00000000000000110110111111101111111011100001101111011210110111111111211111011011
00000111111111210110113111101111111011111011101111011110110111100100000011011011
00111112121111110110111111101111111011111011101111011110110111101101111011111111
00111110000110000110110000000000111000000011100000011110110000001111111011111111
00111111110111111111111111111111111111111111111111111211111111211111011011000000
00110111110111111777777777117777777711777777771110110000111111111100011011111111
11110110000001111711111117117111111711711121111110111110000011001121111011211111
11110111111111111711111117117111111711711111111111011111110111112111111011011000
11110111111111111711111117217111111711711111110000000111101111100000000011011011
00000000111001111711111117117111111711711111121110111121200001111112111111012011
11111111111011111711777777117177777721711111111110110001101112112111111111011011
11111111111011211711111211117111111711711210000110111101100000001100000000011011
11111111111011111711131111117111111711711111110111111111111111101111101110111111
00001100000011211711111111117111111711711111210111111112111112101111201120112111
11101111101111211711000001117111111711711111100000110000001100001110001110000011
11101111101111111711211101117111111711711111111110111110111111101121101110111011
11101100000001011711111101117111111711711111111110111110111111101111101110111011
11101101111111011711211101117111111711777777771110000000111000000111211110110011
11101101111111011111111101111111111111111111111111111111111111211211211110110111
11101100000001011111211101111211112111121111121121121112111211111110000000110111
01101111111101011000000001100011777771177777117777777117777711171110121112111111
01101111111101011111111101110111711171171117117111117117111711171110111111121111
01101100000001011111111101110111711171171117117111117117111711171110000011000000
01111111111111111111111101110111711171171117117111117117111711171111111111111111
01111111100000000001111101110111711171171117117111117117111711171111111111111111
00000011111110111101100000000111711177771117117177777117111711171111111111011111
01111111111110111101111101111111711111111117117111117117111711171110000000001100
01111111111110111101111101111111711111011117117111117117111711171111111111101101
01110110111111110000001101100011711111011117117111117117111711171111000001101101
01110110111111111101111101111011711000000117117111117117111711171111111111101101
01110110111111111101111101111011711111011117117100017117111711171111111111101101
11110110000011110101110001111011711111011117117111017117111777771111100000001101
11110111111111010111110111111011111111011111111111011111111111111111101111111001
11110111111110000111110111111011111111011111111111011111111111111111101111111111
11110110000011101110000111000000110000011100000000011000000001100000000000001011
11110110111111101110111111011110110111011101111110111111111101111111111111101011
11110110111111111110111111011110110111011101111110111211111101111211111111101011
00000110110000000000111211011111110111011101111110111112111101101100011011101011
11111110110111111111111111011121110111011101110000000000001101101111111011101011
11111121110111111112112111011000000111011111111111111011111101101111111012101000
00011111110110111000000000011111011111011111111111111011111101100000000011111111
10111111110110111111111111011111011111000001111011111011111101112111011121112111
10111000000110000000111111011111000011011101111011111000001101112111011121101111
10111111211110111121111111111111121111011101111011121111111101111111011111101111
10000000111110111111111111211111111111011101111011111121111101111211012121101211
11141211111110111100000000000011111111011100000000111111111000000111000000001111
00000000000000000000000000000000000000000000000000000000000000000000000000000000
00000000000000000000000000000000000000000000000000000000000000000000000000000000
00000000000000000000000000000000000000000000000000000000000000000000000000000000
00000000000000000000000000000000000000000000000000000000000000000000000000000000
00000000000000000000000000000000000000000000000000000000000000000000000000000000
00000000000000000000000000000000000000000000000000000000000000000000000000000000
00000000000000000000000000000000000000000000000000000000000000000000000000000000
00000000000000000000000000000000000000000000000000000000000000000000000000000000
00000000000000000000000000000000000000000000000000000000000000000000000000000000
00000000000000000000000000000000000000000000000000000000000000000000000000000000
00000000000000000000000000000000000000000000000000000000000000000000000000000000
00000000000000000000000000000000000000000000000000000000000000000000000000000000
00000000000000000000000000000000000000000000000000000000000000000000000000000000
00000000000000000000000000000000000000000000000000000000000000000000000000000000
00000000000000000000000000000000000000000000000000000000000000000000000000000000
00000000000000000000000000000000000000000000000000000000000000000000000000000000
00000000000000000000000000000000000000000000000000000000000000000000000000000000
00000000000000000000000000000000000000000000000000000000000000000000000000000000
00000000000000000000000000000000000000000000000000000000000000000000000000000000
00000000000000000000000000000000000000000000000000000000000000000000000000000000
00000000000000000000000000000000000000000000000000000000000000000000000000000000
