00000000000000111111110111111011111111010111111111111101110111110101111111000000
00000000000000111111110111111011111111011100000000000001110111111101100000011110
00000000000000110000000000011011100000011111111111011111100011011101111111011110
00000000000000110111111111111011111111011111111111011111111111011100000011011000
00000000000000110111111111111011111111011000011000011111111111011111111111011110
00000000000000110110000110000000000111011011011111011100000000011111111111111110
00000000000000110000111111111111111111011011011111011111111111011101110111111110
00000000000000110110111111111111111111011011000011000000110111000001110110000000
00000000000000110110111001100000000011111011111111011110110001011101110111111111
00000000000000110110111011101111111011000011111111011110111111011101110000000011
00000000000000111110111011101111111011111111101111011110111111011101111111011011
00000000000000111110111011111111000011111111101100011000111100011100000000011011
00000000000000110110111000000000011011111111101100011000111111111111111111011011
00000000000000110110111111101111111011100001101111011110110111111111111111011011
00000111111111110110111111101111111011111011101111011110110111100100000011011011
00111111111111110110111111101111111011111011101111011110110111101101111011111111
00111110000110000110110000000000111000000011100000011110110000001111111011111111
00111111110111111111111111111111111111111111111111111111111111111111011011000000
00110111110111111000000000110000000011000000001110110000111111111100011011111111
11110110000001111011111110110111111011011111111110111110000011001111111011111111
11110111111111111011111110110111111011011111111110111111101111111111111011011000
11110111111111111011111110110111111011011111110000000111101111100000000011011011
00000000111001111011111110110111111011011111111110111111100001111111111111011011
11111111111011111011000000110100000011011111111110110001101111111111111111011011
11111111111011111011111111110111111011011110000110111101100000001100000000011011
11111111111011111011111111110111111011011111110111111111111111101111101110111111
00001100000011111011111111110111111011011111110111111111111111101111101110111111
11101111101111111011000001110111111011011111100000110000001100001110001110000011
11101111101111111011111101110111111011011111111110111110111111101111101110111011
11101100000001011011111101110111111011011111111110111110111111101111101110111011
11101101111111011011111101110111111011000000001110000000111000000111111110110011
11101101111111011111111101111111111111111111111111111111111111111111111110110111
11101100000001011111111101111111111111111111111111111111111111111110000000110111
01101111111101011000000001100011000001100000110000000110000011101110111111111111
01101111111101011111111101110111011101101110110111110110111011101110111111111111
01101100000001011111111101110111011101101110110111110110111011101110000011000000
01111111111111111111111101110111011101101110110111110110111011101111111111111111
01111111100000000001111101110111011101101110110111110110111011101111111111111111
00000011111110111101100000000111011100001110110100000110111011101111111111011111
01111111111110111101111101111111011111111110110111110110111011101110000000001100
01111111111110111101111101111111011111011110110111110110111011101111111111101101
01110110111111110000001101100011011111011110110111110110111011101111000001101101
01110110111111111101111101111011011000000110110111110110111011101111111111101101
01110110111111111101111101111011011111011110110100010110111011101111111111101101
11110110000011110101110001111011011111011110110111010110111000001111100000001101
11110111111111010111110111111011111111011111111111011111111111111111101111111001
11110111111110000111110111111011111111011111111111011111111111111111101111111111
11110110000011101110000111000000110000011100000000011000000001100000000000001011
11110110111111101110111111011110110111011101111110111111111101111111111111101011
11110110111111111110111111011110110111011101111110111111111101111111111111101011
00000110110000000000111111011111110111011101111110111111111101101100011011101011
11111110110111111111111111011111110111011101110000000000001101101111111011101011
11111111110111111111111111011000000111011111111111111011111101101111111011101000
00011111110110111000000000011111011111011111111111111011111101100000000011111111
10111111110110111111111111011111011111000001111011111011111101111111011111111111
10111000000110000000111111011111000011011101111011111000001101111111011111101111
10111111111110111111111111111111111111011101111011111111111101111111011111101111
10000000111110111111111111111111111111011101111011111111111101111111011111101111
11111211111110111100000000000011111111011100000000111111111000000111000000001111
00000000000000000000000000000000000000000000000000000000000000000000000000000000
00000000000000000000000000000000000000000000000000000000000000000000000000000000
00000000000000000000000000000000000000000000000000000000000000000000000000000000
00000000000000000000000000000000000000000000000000000000000000000000000000000000
00000000000000000000000000000000000000000000000000000000000000000000000000000000
00000000000000000000000000000000000000000000000000000000000000000000000000000000
00000000000000000000000000000000000000000000000000000000000000000000000000000000
00000000000000000000000000000000000000000000000000000000000000000000000000000000
00000000000000000000000000000000000000000000000000000000000000000000000000000000
00000000000000000000000000000000000000000000000000000000000000000000000000000000
00000000000000000000000000000000000000000000000000000000000000000000000000000000
00000000000000000000000000000000000000000000000000000000000000000000000000000000
00000000000000000000000000000000000000000000000000000000000000000000000000000000
00000000000000000000000000000000000000000000000000000000000000000000000000000000
00000000000000000000000000000000000000000000000000000000000000000000000000000000
00000000000000000000000000000000000000000000000000000000000000000000000000000000
00000000000000000000000000000000000000000000000000000000000000000000000000000000
00000000000000000000000000000000000000000000000000000000000000000000000000000000
00000000000000000000000000000000000000000000000000000000000000000000000000000000
00000000000000000000000000000000000000000000000000000000000000000000000000000000
00000000000000000000000000000000000000000000000000000000000000000000000000000000
